{
  "name": "Dactyl Manuform (5x6_3)",
  "vendorProductId": 1634886753,
  "macros": ["", "", "", "", "", "", "", "", "", "", "", "", "", "", "", ""],
  "layers": [
    [
      "KC_ESC",
      "KC_TAB",
      "KC_LSFT",
      "KC_LCTL",
      "KC_NO",
      "KC_1",
      "KC_Q",
      "KC_A",
      "KC_Z",
      "KC_LGUI",
      "KC_2",
      "KC_W",
      "KC_S",
      "KC_X",
      "KC_GRV",
      "KC_3",
      "KC_E",
      "KC_D",
      "KC_C",
      "KC_LALT",
      "KC_4",
      "KC_R",
      "KC_F",
      "KC_V",
      "LT(1,KC_SPC)",
      "KC_5",
      "KC_T",
      "KC_G",
      "KC_B",
      "KC_TAB",
      "KC_MINS",
      "KC_EQL",
      "KC_QUOT",
      "KC_RSFT",
      "KC_TAB",
      "KC_0",
      "KC_P",
      "KC_SCLN",
      "KC_SLSH",
      "KC_RCTL",
      "KC_9",
      "KC_O",
      "KC_L",
      "KC_DOT",
      "KC_RALT",
      "KC_8",
      "KC_I",
      "KC_K",
      "KC_COMM",
      "LT(2,KC_SPC)",
      "KC_7",
      "KC_U",
      "KC_J",
      "KC_M",
      "KC_BSPC",
      "KC_6",
      "KC_Y",
      "KC_H",
      "KC_N",
      "KC_ENT"
    ],
    [
      "KC_TRNS",
      "KC_TRNS",
      "KC_TRNS",
      "KC_TRNS",
      "KC_BSPC",
      "KC_TRNS",
      "KC_TRNS",
      "KC_TRNS",
      "KC_TRNS",
      "KC_TRNS",
      "KC_TRNS",
      "KC_HOME",
      "KC_LEFT",
      "KC_DEL",
      "KC_TRNS",
      "KC_TRNS",
      "KC_UP",
      "KC_DOWN",
      "KC_PGUP",
      "KC_TRNS",
      "KC_TRNS",
      "KC_END",
      "KC_RGHT",
      "KC_PGDN",
      "KC_TRNS",
      "KC_TRNS",
      "KC_TRNS",
      "KC_TRNS",
      "KC_TRNS",
      "KC_TRNS",
      "KC_TRNS",
      "KC_TRNS",
      "KC_TRNS",
      "KC_TRNS",
      "KC_TRNS",
      "KC_TRNS",
      "KC_TRNS",
      "KC_TRNS",
      "KC_TRNS",
      "KC_TRNS",
      "KC_TRNS",
      "KC_TRNS",
      "KC_TRNS",
      "KC_TRNS",
      "KC_TRNS",
      "KC_TRNS",
      "KC_TRNS",
      "KC_TRNS",
      "KC_TRNS",
      "KC_TRNS",
      "KC_TRNS",
      "KC_TRNS",
      "KC_TRNS",
      "KC_TRNS",
      "KC_TRNS",
      "KC_TRNS",
      "KC_TRNS",
      "KC_TRNS",
      "KC_TRNS",
      "KC_TRNS"
    ],
    [
      "KC_F1",
      "KC_TRNS",
      "KC_TRNS",
      "KC_TRNS",
      "KC_TRNS",
      "KC_F2",
      "KC_TRNS",
      "KC_TRNS",
      "KC_TRNS",
      "KC_TRNS",
      "KC_F3",
      "KC_TRNS",
      "KC_TRNS",
      "KC_TRNS",
      "KC_TRNS",
      "KC_F4",
      "KC_TRNS",
      "KC_TRNS",
      "KC_TRNS",
      "KC_TRNS",
      "KC_F5",
      "KC_TRNS",
      "KC_TRNS",
      "KC_TRNS",
      "KC_TRNS",
      "KC_F6",
      "KC_TRNS",
      "KC_TRNS",
      "KC_TRNS",
      "KC_TRNS",
      "KC_F12",
      "KC_PAST",
      "KC_PMNS",
      "KC_TRNS",
      "KC_TRNS",
      "KC_F11",
      "KC_PSLS",
      "KC_PPLS",
      "KC_TRNS",
      "KC_PDOT",
      "KC_F10",
      "KC_P9",
      "KC_P6",
      "KC_P3",
      "KC_P0",
      "KC_F9",
      "KC_P8",
      "KC_P5",
      "KC_P2",
      "KC_TRNS",
      "KC_F8",
      "KC_P7",
      "KC_P4",
      "KC_P1",
      "KC_TRNS",
      "KC_F7",
      "KC_TRNS",
      "KC_TRNS",
      "KC_TRNS",
      "KC_TRNS"
    ],
    [
      "KC_F12",
      "KC_PAST",
      "KC_PMNS",
      "KC_TRNS",
      "KC_TRNS",
      "KC_TRNS",
      "KC_F11",
      "KC_PSLS",
      "KC_PPLS",
      "KC_TRNS",
      "KC_PDOT",
      "KC_TRNS",
      "KC_F10",
      "KC_P9",
      "KC_P6",
      "KC_P3",
      "KC_P0",
      "KC_TRNS",
      "KC_F9",
      "KC_P8",
      "KC_P5",
      "KC_P2",
      "KC_TRNS",
      "KC_TRNS",
      "KC_F8",
      "KC_P7",
      "KC_P4",
      "KC_P1",
      "KC_TRNS",
      "KC_TRNS",
      "KC_F7",
      "KC_TRNS",
      "KC_TRNS",
      "KC_TRNS",
      "KC_TRNS",
      "KC_TRNS",
      "KC_TRNS",
      "KC_TRNS",
      "KC_TRNS",
      "KC_TRNS",
      "KC_TRNS",
      "KC_TRNS",
      "KC_TRNS",
      "KC_TRNS",
      "KC_TRNS",
      "KC_TRNS",
      "KC_TRNS",
      "KC_TRNS",
      "KC_TRNS",
      "KC_TRNS",
      "KC_TRNS",
      "KC_TRNS",
      "KC_TRNS",
      "KC_TRNS",
      "KC_TRNS",
      "KC_TRNS",
      "KC_TRNS",
      "KC_TRNS",
      "KC_TRNS",
      "KC_TRNS"
    ]
  ],
  "encoders": []
}